5 5
1 1 1 1 1
1 8 1 1 1
1 2 3 3 1
1 4 1 11 1
1 1 1 1 1
g g g g g
g g g g g
g g g g g
g g g g g
g g l l w